1111111111111
10010000000C1
1000011111001
1P0E110000001
100000C00C001
1000000000001
10000000110C1
1000001110001
10C0000010001
1111111111111