1111111111111111111
111111P011111111111
1111110C11111111111
1000C00000C0000C001
1000000000000000001
1C0000C00000C000001
1000C11111100010001
1111111111111E1C111
1111111111111111111
1111111111111111111