111111111
100P11111
1C0P11111
10E011111
111111111